# # # # . . . . . .
# # # # # # . . # .
# . . . . # . . # .
. . # . . # # # # .
. . . # ^ # # . # .
. # . . # # # . # .
. # # # # # . . # .
. . . . . . . . . .

